000000000000000000000000000000
00..........@@..11..1111....00
00..........@@..11..1111....00
00...111111111..11..........00
00...111111111..11..........00
00......1...11..1111..%%%%%%00
00......1...11..1111..%%%%%%00
00...1..........@@..%%%%%%%%00
00...1..........@@..%%%%%%%%00
00...1..111111@@1111%%%%11@@00
00...1..111111@@1111%%%%..@@00
00..111111@@....11..%%%%...100
00........@@....11..%%%%...100
00.1111111..@@%%%%%%%%%%....00
00.1111111..@@%%%%%%%%%%....00
00......@@....%%%%%%%%%%11..00
00......@@....%%%%%%%%%%11..00
00@@11..%%%%%%%%@@%%%%%%11..00
00@@11..%%%%%%%%@@%%%%%%11..00
00.111%%%%%%%%%%........111.00
00.111%%%%%%%%%%........111.00
00..11%%%%........@@111111..00
00..11%%%%..........111111..00
00....%%%%..........11...1..00
00....%%%%...1111...11...1..00
00....%%%%...1..1...........00
00..11%%%%...1..1...........00
000000000000000000000000000000